1111111111111111111111111111
100p000000000110000000000001
1011110111110110111110111101
1411110111110110111110111141
1011110111110110111110111101
1000000000000000000000000001
1011110110111111110110111101
1011110110111111110110111101
1000000110000110000110000001
1111110111113113111110111111
3333310111113113111110133333
3333310113333333333110133333
3333310113111221113110133333
1111110113133333313110111111
1333330333133333313330333331
1111110113133333313110111111
3333310113111111113110133333
3333310113333333333110133333
3333310113111111113110133333
1111110113111111113110111111
1000000000000110000000000001
1011110111110110111110111101
1011110111110110111110111101
1400110000000000000000110041
1110110110111111110110110111
1110110110111111110110110111
1000000110000110000110000001
1011111111110110111111111101
1011111111110110111111111101
1000000000000000000000000001
1111111111111111111111111111

28 columnas de ancho - 31 filas de largo
0 ->bolita
1 ->pared
2 ->puerta
3 ->en blanco u oscuro
4 -> super bolita
p ->pacman
